{
    "lv1":[
        {"ts":1, "ms":2},
        {"ts":1, "ms":3},
        {"ts":1, "ms":4},
        {"ts":1, "ms":5},
        {"ts":1, "ms":10}
    ],
    "lv2":[
        {"ts":1, "ms":2},
        {"ts":1, "ms":3},
        {"ts":1, "ms":6},
        {"ts":1, "ms":7},
        {"ts":1, "ms":10}
    ]
}
